111111111111111111111111
1E000000000000000C000001
101001010010000010100101
100001001010101000100101
101111001010101000100101
101000001010101000100101
10000C00000010100C100101
100000000000001000100001
100000000000101000100001
101111000011101000100001
1P00C0000000000000000001
111111111111111111111111
