11111111111111111111
1E000000000000000C01
10100101001000001001
10000100101010100001
10111100101010100001
10100000101010100001
10000C00000010100C01
10000000000000100001
10000000000010100001
10111100001110100001
1P00C000000000000001
11111111111111111111
