11111111111111111111111111111
1E0000000000000C00000C0000001
10100101001000001010010010101
10000100101010100010010010101
10111100101010100010010010101
10100000101010100010010010101
10000000000010100010010010101
10000000000000100010000010101
100000000000101000100C0010101
100000000000101000100C0010101
10000000000010100010000010101
10111100001110100010000010101
1P0000000C00C00000000000000C1
11111111111111111111111111111
