111111111111111
11000C0000000E1
111110000001111
1000000000000P1
111111111111111